###############################
#...................#.........#
#.###.#.###########...#######.#
#...#.#.....#.......#.....#...#
###.#.#####.#.###########.#.###
#...#.....#.#.....#.......#...#
#.#######.#.###E#.#.#####.###.#
#.......#.#...#.#.#...#.....#.#
#.#####.#.###.#.#.###.#####.#.#
#.#.....#...#...#...#.....#...#
#.#.#######.#######.#####.###.#
#.#.......#.........#.....#...#
#.#######.#####.#.###.#####.###
#...............#............S#
###############################