###############################
#E..................#.........#
#.###.#.###########.#.#######.#
#...#.#.....#.......#.....#...#
###.#.#####.#.###########.#.###
#...#.....#.#.....#.......#...#
#.#######.#.###.#.#.#####.###.#
#.......#.#...#.#.#...#.....#.#
#.#####.#.###.#.#.###.#####.#.#
#.#.....#...#...#...#.....#...#
#.#.#######.#######.#####.###.#
#.#.......#.........#.....#...#
#.#######.#####.#.###.#####.###
#S..............#.............#
###############################