###############################
#S..................#........E#
#.###.#.###########.#.#######.#
#...#.#.....#.......#.....#...#
###.#.#####.#.###########.#.###
#...#.....#.#.....#.......#...#
#.#######.#.###.#.#.#####.###.#
#.......#.#...#.#.#...#.....#.#
#.#####.#.###.#.#.###.#####.#.#
#.#.....#...#...#...#.....#...#
#.#.#######.#######.#####.###.#
#.#.......#.........#.....#...#
#.#######.#####.#.###.#####.###
#...............#.............#
###############################